1111111111111111111111111111
1000000010000000000000000001
10000000100000000000CC000001
100C000010C00000000000000001
1111100011111001110000010001
1000000000000000000000000001
1000000000000000000000000001
1000000C00000C0000000000E001
1000000101111111000001111001
1000C00101000000000000000001
10100000010000000000C0000001
1000000111000010000000000001
1000111000000000000000000001
10P000000000C000000000C00001
1111111111111111111111111111