111111111111111
1000C0000000001
10011100000C001
100000000111111
111010000000001
100C10000000001
11111110000E001
100C000000110C1
101100000001001
100000011111001
100010000001001
1P001C110000C01
111111111111111